1,1,1,1,1,1,1,1,1,1,1,1,1,1,1,1
1,1,1,1,1,1,1,1,1,1,1,1,1,1,1,1
1,1,1,1,1,1,1,1028,1,1,1,1,1,1,1,1
1,1,1,1,1,1,1,1028,1,1,1,1,1,1,1,1
1,1,1,1,1,1,1,1028,1,1,1,1,1,1,1,1
1,1,1,1,1,1,1,1028,1,1,1,1,1,1,1,1
1,1,1,1,1,1,1,1028,1,1,1,1,1,1,1,1
1,1,1,1,1,1,1,1028,1,1,1,1,1,1,1,1
1,1,1,1,1,1,1,1028,1,1,1,1,1,1,1,1
1,1,1,1,1,1,1,1028,1,1,1,1,1,1,1,1
1,1,1,1,1,1,1,1028,1,1,1,1,1,1,1,1
1,1,1,1,1,1,1,1028,1,1,1,1,1,1,1,1
1,1,1,1,1,1,1,1028,1,1,1,1,1,1,1,1
1,1,1,1,1,1,1,1028,1,1,1,1,1,1,1,1
0,0,0,0,0,0,1,1028,1,1,1,1,1,1,1,1
0,0,0,0,0,0,1,1028,1,1,1,1,1,1,1,1
0,0,0,0,0,0,1028,1028,1,1,1,1,1,1,1,1
0,0,0,0,0,0,1028,1,1,1,1,1,1,1,1,1
0,0,0,0,0,0,1028,1,1,1,0,0,0,1,1,1
0,0,1,1,1,1,1028,1,1,1,0,0,0,1,1,1
0,0,1,1,1,1,1028,1,1,1,0,0,0,1,1,1
0,0,1,1,1,1,1028,1,1,1,0,0,0,1,1,1
0,0,1,1,1,1,1028,1,1,1,0,0,0,1,1,1
0,0,1,1,1,1028,1028,1,1,1,0,0,0,1,1,1
0,0,1,1,1,1028,1,1,1,1,1,1,1,1,1,1
0,0,1,1,1,1028,1,1,1,1,1,1,1,1,1,1
0,0,1,1,1,1028,1,1,1,1,1,1,1,1,1,1
0,0,1,1,1,1028,1,1,1,1,1,1,1,1,1,1
0,0,1,1,1,1028,1,1,1,1,1,1,1,1,1,1
0,0,1,1,1,1028,1,1,1,1,1,1,1,1,1,1
0,0,1,1,1028,1028,1,1,1,1,1,1,1,1,1,1
0,0,1,1028,1028,1,1,1,1,1,1,1,1,1,1,1
0,0,1,1028,1,1,1,1,1,1,1,1,1,1,1,1
0,0,1,1028,1,1,1,1,1,1,1,1,1,1,1,1
0,0,1,1,1,1,1,1,1,1,1,1,1,1,1,1
0,0,1,1,1,1,1,1,1,1,1,1,1,1,1,1
0,0,1,1,1,1,1,1,1,1,1,1,1,1,1,1
